NO       ./pics/backroom.xpm
SO 		   	  	 	 	 	  ./pics/backroom.xpm
EA ./pics/backroom.xpm
WE ./pics/backroom.xpm

F 220,203,91
C 255,255,255

111111
100001
100W01
100001
111111