EA				./AAAAAAAAAAAAAAAAAAAAAAAAAAAAAAAAAAAAa.xpm
NO       ./p1/texture.xpm

SO 		   	  	 	 	 	  ./p2/texture.xpm


WE 		   	  	 	 	 	  ./3/texture.xpm




F 5,01,5
C 0,0,0

1111
1S01
1111
1001
1111
