NO       ./pics/greystone.xpm
SO 		   	  	 	 	 	  ./pics/redbrick.xpm
EA ./pics/bluestone.xpm
WE ./pics/purplestone.xpm

F 005,001,005
C 25,3,255

111111111111111111111111
1000000000S0000000000001
100000000000000000000001
100000000000000000000001
100000000000000000000001
100000000001000000000001
100000000000000000000001
100000000000000000000001
100000000000000000000001
100000000000000000000001
111111111111111111111111